WW..W...............
WWW.W....G.WW.......
WWW.W...WWWWW.WWW...
...............WW.W.
..WWW...WW..WWWWW.WW
....W...W...WWWWW..W
WW..W..WWW..WWWWW..W
WW..W..WWW..W.......
....W...............
WWWWWWWWWWWWW..WWW.W
........W..........W
WWWW..WWWW..WW..WWWW
.............W..W...
WW.WWW..WWW..W..W.WW
WW.W................
WW.....WWWWW..WWWWWW
W.......SW......WWW.
WW.......WW.......W.
W........WW...WWWWW.
..................W.